##################
#P    C#      B  #
#      #      #  #
#      #     C# E#
#C     #      ####
######B#BB########
#B     #      ####
#      #        C#
#B   CB         K#
##################