##########
#    #   #
#    #   #
#    #   #
#    #   #
##########